{
  "ground": [
    [0,0,0,0,0,0,0,0,0,0,0,0],
    [0,2,2,0,0,0,0,0,0,0,0,0],
    [0,2,2,0,0,0,0,0,0,0,0,0],
    [0,0,0,0,0,0,0,0,0,0,0,0],
    [0,2,2,0,0,0,0,0,0,0,0,0],
    [0,2,2,0,0,0,0,0,0,0,0,0],
    [0,2,2,0,0,0,0,0,0,0,0,0],
    [0,2,2,0,0,0,0,0,0,0,0,0],
    [0,0,0,0,0,0,0,0,0,0,0,0],
    [0,0,0,0,0,0,0,0,0,0,0,0],
    [0,0,0,0,0,0,0,0,0,0,0,0]
  ],
  "height": [
    [1,1,1,1,1,1,1,1,1,1,1,1],
    [1,2,2,1,1,1,1,1,1,1,1,1],
    [1,2,2,1,1,1,1,1,1,1,1,1],
    [1,1,1,1,1,1,1,1,1,1,1,1],
    [1,2,2,1,1,1,1,1,1,1,1,1],
    [1,2,2,1,1,1,1,1,1,1,1,1],
    [1,2,2,1,1,1,1,1,1,1,1,1],
    [1,2,2,1,1,1,1,1,1,1,1,1],
    [1,1,1,1,1,1,1,1,1,1,1,1],
    [1,1,1,1,1,1,1,1,1,1,1,1],
    [1,1,1,1,1,1,1,1,1,1,1,1]
  ],
  "objects": [
    [0,0,0,0,0,0,0,0,0,0,0,0],
    [0,0,0,0,0,0,0,0,0,0,0,0],
    [0,0,0,0,0,0,0,0,0,0,0,0],
    [0,0,0,0,0,0,0,0,0,0,0,0],
    [0,0,0,0,0,0,0,0,0,0,0,0],
    [0,0,0,0,0,0,0,0,0,0,0,0],
    [0,0,0,0,0,0,0,0,0,0,0,0],
    [0,0,0,0,0,0,0,0,0,0,0,0],
    [0,0,0,0,5,4,4,4,7,0,0,0],
    [0,0,0,0,0,0,0,0,0,0,0,0],
    [0,0,0,0,0,0,0,0,0,0,0,0]
  ]
}